"x41":"A",
"x42":"B",
"x43":"C",
"x44":"D",
"x45":"E",
"x46":"F",
"x47":"G",
"x48":"H",
"x49":"I",
"x4A":"J",
"x4B":"K",
"x4C":"L",
"x4D":"M",
"x4E":"N",
"x4F":"O",
"x50":"P",
"x51":"Q",
"x52":"R",
"x53":"S",
"x54":"T",
"x55":"U",
"x56":"V",
"x57":"W",
"x58":"X",
"x59":"Y",
"x5A":"Z",